ANIMAL,SPCSVT_ID_NUMBER,CERT_ID_NUMBER,FISCAL_YEAR,ANYU,NPND,WPWD,WPND,TOTAL,ORDERME
 DOGS,5,15,2008,6,39,2,0,41,0
 CATS,6,15,2008,0,0,202,0,202,0
 GUINEA PIGS,7,15,2008,0,0,8,0,8,0
 HAMSTERS,8,15,2008,180,88,24,0,112,0
 RABBITS,9,15,2008,0,0,0,0,0,0
 NONHUMAN PRIMATES,10,15,2008,0,0,0,0,0,0
 SHEEP,12,15,2008,0,0,0,0,0,0
 PIG,13,15,2008,0,0,0,0,0,0
 OTHER FARM ANIMALS,14,15,2008,0,0,0,0,0,0
 ALL OTHER COVERED SPECIE,99,15,2008,213,168,237,0,405,0