ANIMAL,SPCSVT_ID_NUMBER,CERT_ID_NUMBER,FISCAL_YEAR,ANYU,NPND,WPWD,WPND,TOTAL,ORDERME
 DOGS,5,70,2001,0,10,102,0,112,0
 CATS,6,70,2001,0,0,0,0,0,0
 GUINEA PIGS,7,70,2001,0,61,0,0,61,0
 HAMSTERS,8,70,2001,0,15,266,0,281,0
 RABBITS,9,70,2001,0,0,164,0,164,0
 NONHUMAN PRIMATES,10,70,2001,0,0,0,0,0,0
 SHEEP,12,70,2001,0,0,0,0,0,0
 PIG,13,70,2001,0,0,255,0,255,0
 OTHER FARM ANIMALS,14,70,2001,0,0,0,0,0,0
 ALL OTHER COVERED SPECIE,99,70,2001,0,0,0,0,0,0