ANIMAL,SPCSVT_ID_NUMBER,CERT_ID_NUMBER,FISCAL_YEAR,ANYU,NPND,WPWD,WPND,TOTAL,ORDERME
 DOGS,5,70,2006,0,5,13,0,18,0
 CATS,6,70,2006,0,0,0,0,0,0
 GUINEA PIGS,7,70,2006,0,0,0,0,0,0
 HAMSTERS,8,70,2006,0,362,117,0,479,0
 RABBITS,9,70,2006,0,5,6,0,11,0
 NONHUMAN PRIMATES,10,70,2006,0,0,0,0,0,0
 SHEEP,12,70,2006,0,0,0,0,0,0
 PIG,13,70,2006,0,0,151,0,151,0
 OTHER FARM ANIMALS,14,70,2006,0,0,7,0,7,0
 ALL OTHER COVERED SPECIE,99,70,2006,0,0,0,0,0,0