ANIMAL,SPCSVT_ID_NUMBER,CERT_ID_NUMBER,FISCAL_YEAR,ANYU,NPND,WPWD,WPND,TOTAL,ORDERME
 DOGS,5,400,2007,0,0,0,0,0,0
 CATS,6,400,2007,0,13,0,0,13,0
 GUINEA PIGS,7,400,2007,0,0,0,0,0,0
 HAMSTERS,8,400,2007,0,0,0,0,0,0
 RABBITS,9,400,2007,0,11,0,1,12,0
 NONHUMAN PRIMATES,10,400,2007,0,0,0,0,0,0
 SHEEP,12,400,2007,2,0,4,0,4,0
 PIG,13,400,2007,0,0,0,0,0,0
 OTHER FARM ANIMALS,14,400,2007,9,29,2,0,31,0
 ALL OTHER COVERED SPECIE,99,400,2007,3,58,384,6,448,0