ANIMAL,SPCSVT_ID_NUMBER,CERT_ID_NUMBER,FISCAL_YEAR,ANYU,NPND,WPWD,WPND,TOTAL,ORDERME
 DOGS,5,400,2001,0,0,0,0,0,0
 CATS,6,400,2001,0,1,0,0,1,0
 GUINEA PIGS,7,400,2001,0,0,0,0,0,0
 HAMSTERS,8,400,2001,0,0,0,0,0,0
 RABBITS,9,400,2001,74,20,54,0,74,0
 NONHUMAN PRIMATES,10,400,2001,0,0,0,0,0,0
 SHEEP,12,400,2001,23,12,0,0,12,0
 PIG,13,400,2001,0,0,0,0,0,0
 OTHER FARM ANIMALS,14,400,2001,44,31,2,0,33,0
 ALL OTHER COVERED SPECIE,99,400,2001,0,250,168,4,422,0