ANIMAL,SPCSVT_ID_NUMBER,CERT_ID_NUMBER,FISCAL_YEAR,ANYU,NPND,WPWD,WPND,TOTAL,ORDERME
 DOGS,5,400,2002,0,0,0,0,0,0
 CATS,6,400,2002,0,3,0,0,3,0
 GUINEA PIGS,7,400,2002,0,0,0,0,0,0
 HAMSTERS,8,400,2002,0,0,0,0,0,0
 RABBITS,9,400,2002,85,15,36,0,51,0
 NONHUMAN PRIMATES,10,400,2002,0,0,0,0,0,0
 SHEEP,12,400,2002,9,12,0,0,12,0
 PIG,13,400,2002,0,0,0,0,0,0
 OTHER FARM ANIMALS,14,400,2002,38,34,5,0,39,0
 ALL OTHER COVERED SPECIE,99,400,2002,0,14,74,2,90,0