ANIMAL	SPCSVT_ID_NUMBER	CERT_ID_NUMBER	FISCAL_YEAR	ANYU	NPND	WPWD	WPND	TOTAL	ORDERME
 DOGS	5	400	2003	0	0	0	0	0	0
 CATS	6	400	2003	0	11	0	0	11	0
 GUINEA PIGS	7	400	2003	0	0	0	0	0	0
 HAMSTERS	8	400	2003	0	0	0	0	0	0
 RABBITS	9	400	2003	69	17	67	0	84	0
 NONHUMAN PRIMATES	10	400	2003	0	0	0	0	0	0
 SHEEP	12	400	2003	11	10	0	0	10	0
 PIG	13	400	2003	0	0	0	0	0	0
 OTHER FARM ANIMALS	14	400	2003	38	37	3	0	40	0
 ALL OTHER COVERED SPECIE	99	400	2003	0	23	179	0	202	0