ANIMAL,SPCSVT_ID_NUMBER,CERT_ID_NUMBER,FISCAL_YEAR,ANYU,NPND,WPWD,WPND,TOTAL,ORDERME
 DOGS,5,400,2005,0,0,0,0,0,0
 CATS,6,400,2005,0,2,0,0,2,0
 GUINEA PIGS,7,400,2005,0,0,0,0,0,0
 HAMSTERS,8,400,2005,0,0,0,0,0,0
 RABBITS,9,400,2005,1,0,14,0,14,0
 NONHUMAN PRIMATES,10,400,2005,0,0,0,0,0,0
 SHEEP,12,400,2005,4,6,0,0,6,0
 PIG,13,400,2005,0,0,0,0,0,0
 OTHER FARM ANIMALS,14,400,2005,33,21,4,0,25,0
 ALL OTHER COVERED SPECIE,99,400,2005,25,16,578,1,595,0